R 1920 1080
NO ./textures/aphexTwinCanny/aphexTwinCanny1.png
EA ./textures/aphexTwinCanny/aphexTwinCanny4.png
SO ./textures/aphexTwinCanny/aphexTwinCanny2.png
WE ./textures/aphexTwinCanny/aphexTwinCanny3.png

F 0,0,0
C 0,0,0

S ./textures/aphexTwinCanny/aphexTwinLogoWhite.png

1111111111111
1020002000201
1000000000001
1020002000201
1000000000001
1020002000201
1000000000001
1020002000201
1000000000001
1020002000201
1000000000001
1111101111111
1111100000111
1111111110111
1000000010111
1011111000111
1000001111111
1111101111111
1100000001111
1100000001111
1102020201111
1100000001111
1100000001111
1111101111111
1000001111111
1011111000011
1010000011011
1010111111011
1000100000011
1111101111111
1111000111111
1111020111111
1111000111111
1111101111111
1100001111111
1101111111111
1001000111111
1011010111111
1000010000W11
1111111111111
