R 1920 1080
NO ./textures/poorThings/assistantBaxter.png
SO ./textures/poorThings/baxterTwo.png
WE ./textures/poorThings/baxter.png
EA ./textures/poorThings/bellaResurrection.png

F 20,20,20
C 0,0,0

S ./textures/poorThings/bellaGod.png

11111111111
10000000001
10000000001
10000000001
10000000001
10000N00001
10000000001
10000000001
10000000001
10000000001
11111111101
1111100000111
1000001111111
1011111000011
1010000011011
1010111111011
1000100000011
1111101111111
1111101111111
1100000001111
1100000001111
1100020001111
1100000001111
1111111111111
